поза - полуфлексорная
крик - громкий
активность спонтанная - удовлетворительная
реакция на осмотр - живая
телосложение - правильное
кожа - высыпаний нет, кожные покровы чистые
кожные покровы - чистые, розовые
отделяемое из глаз - нет
конъюнктивы - чистые, розовые
подкожная клетчатка - развита удовлетворительно, равномерно
тургор - достаточный
эластичность - удовлетворительная
лимотические узлы - не пальпируются
пуповинный остаток - в скобе
головка - округлая
состояние костей черепа - плотные, швы на стыке
родничок - размеры 1,5*1,5см, не напряжен
форма грудной клетки - правильная, симметричная
перкуссия - легочный звук
дыхания - физиологичесоке, ЧД 40/мин
носовое дыхание - свободное
аускультация легких - аускультативно дыхание пуэрильное
аускультация сердца - тоны ясные, ритмичные. Пульс 140 в минуту, ЧСС 140/мин
нервная система - рефлексы вызываются
симметричность кожных складок - симметричны
симметричность мягкого неба, язычка - симметричны
фонация - есть
живот - мягкий, симметричный
анус - есть
реакция на звук - есть
положение головы и плеч - срединное
мышечный тонус - удовлетворительный
слизистые - чистые, розовые, язык чистый, влажный
живот - мягкий, печень не увеличена, селезенка не пальпируется
отхождение мекония - было
мочеиспускание - было
тазобедренные суставы - движение в полном обьеме
лактация - достаточная
localis - без особенностей
